111111111111111111
1111110111111E1111
111000000011110111
1C1111011111P11111
111111111111111111
