11111111111111111111111111111111
1P000001111001111111111111111111
10111000001001111000001111011111
10000000001001111001111111111111
100000000C1001111001111111111111
10111000001001111001111111101111
100000E0001001111001111111111111
11110000000001111111111111111111
11111111111111111111111111111111
11111111111111111111111111111111
10000000000000000000000000000001
10000000000000000000000000000001
11111111111111111111111111111111
