1111111111111111111
10011111110P0001111
1001111111000001111
1001111111111001111
1001111111000001111
1001001111000001111
10000E00110C1111111
1000000011000001111
1111001111000001111
1111111111111111111
