1111111111111111111111111111111111111111111111111111
1P00000000001100000000000110000000000011000000000001
1010001000101101000100010000100010001011010001000101
1010101010100001010101010110101010101000010101010101
1000000010001100010001000110000000100011000100010001
1010101010101101010101010110101010101011010101010101
10001C001000110001C0E1000110001C001000110001C0010001
11C1011111C0000C1111101C1111C1011111C0000C1111101C11
1101111111111111111111101111011111111111111111111011
1000000000001100000000000110000000000011000000000001
1010001000101101000100010110100010001011010001000101
1010101010100001010101010110101010101000010101010101
1000100010001100010001000110001000100011000100010001
1010101010101101010101010110101010101011010101010101
10001C001000110001C001000110001C001000110001C0010001
11C1111111C1111C1111111C1111C1111111C1111C1111111C11
1000111111111111111111000110001111111111111111110001
1010000000000000000000010000100000000000000000000101
1000111110000011111111000110001111100000111111110001
1111111111111111111111111111111111111111111111111111
