1111111111111111111111111111111111111111111111111111111111
111C001111111111111111111111111111111111111111111111111111
1111000001111111111111111111111111111111111111111111111111
1111110001111111111111111111111111111111111111111111111111
1111110011111111111111111111110111111111111111111111111111
1111111111111111111111111111100011111111111111111110111111
1111111111111111111111110111000001111111111111111100011111
1111111111111111111111100110000000111111111111100010000011
1111CC1111111111111111000000000000011111111111111111111111
11111C1111111111111100000111111111111111111111111111111111
1111111111111111111111111111111111111111111111111111111111
1E111111111111111111111111111111111111111111111111111111P1
1111111111111111111111111111111111111111111111111111111111
